-14
5
-6
3
00000000000000000000
00000000000000010000
00000000000000000000
11111110000000000010
11111110000000000000
11111110000000000000
11111110000000000000
11111110001000000000
11111110000000000000
11111110100000000000
