-17
19
-9
7
0000000000000000000000000000000000000
1111111111111111111111111111111111110
0000000000000000000000000000000000010
0000000000000000000000000000000000010
0000000000000000000000000000011100010
0000000000000000001000000000010100010
0000000000000000000000000000011100010
0001111111000000000001000000000000010
0001111111000000000000000000000000010
0001111111000000000000000000000000010
0001111111000000000000000000000000010
0001111111000100000000000000000000010
0001111111000000000000000000000000010
0001111111010000000000000000000000010
0000000000000000000000000000000000010
0000000000000000000000000000000000010
0000000000000000000000000000000000010
